1111111111111111
100C000CC0000C01
1P0C0000000C0001
101000C000000001
1CE000C000000C01
1C0000C0000C0001
1111111111111111