11111111111
1P0C0000001
101000C0001
1CE000C0001
11111111111